XPT2046_Touchscreen_TT	KEYWORD1
TS_Point	KEYWORD1
begin	KEYWORD2
getPoint	KEYWORD2
touched	KEYWORD2
tirqTouched	KEYWORD2
readData	KEYWORD2
bufferEmpty	KEYWORD2
bufferSize	KEYWORD2
setRotation	KEYWORD2
setThresholds	KEYWORD2
Zthreshold	KEYWORD2
Zthreshold_Int	KEYWORD2
TS_Display	KEYWORD1
getTouchEvent	KEYWORD2
setTouchReleaseParams	KEYWORD2
getTS_calibration	KEYWORD2
setTS_calibration	KEYWORD2
mapTStoDisplay	KEYWORD2
mapDisplayToTS	KEYWORD2
GetCalibration_UL_LR	KEYWORD2
findTS_calibration	KEYWORD2
